%%%%%%%%%%%%%%%%%%%%%%%%%%%%%%%%%%%%%
%       % % %           %   %     % %
% %%%%%%% % %%% % %%% %%% %%%%%%% % %
%       %       % %     %     % %   %
%%%%% %%%%% %%% % % % %%% %%%%% % %%%
%   % % % %   % % % %   % %   % %   %
% %%% % % % %%% %%%%% %%% % %%% %%% %
%       %     %   %   %  %  % % %   %
%%% %%%%%%%%% %%%%%%% %%% %%% % % % %
%             %       % %   %     % %
% % %%%%% % %%% % % %%% % %%% %%% % %
% % %     % % % % %     %   % % % % %
% % % %%%%%%% % %%%%%%%%% %%% % %%% %
% % % %     %   %     %     %   %   %
%%% %%% % %%%%% %%%%% %%% %%% %%%%% %
%     % % %     % %     % %   % % % %
% % % % % %%% %%% %%% %%% % % % % % %
% % %%% %                 % % %     %
%%% %%%%%%% % % %%%%% %%% % %%% %%%%%
%       % % % %     %   %     % %   %
%%%%% % % %%%%%%%%% %%%%%%%%%%% % %%%
%   % %           % %     %   % %   %
% %%% %%%%% %%%%%%%%% %%%%% % % %%% %
% %   %      %        %     %       %
% % % %%%%% %%% % % % % %%%%%%%%%%%%%
% % %   %     % % % %       %   % % %
% % %%% %%% % % % %%%%%%%%% %%% % % %
% %   % %   % % %   % %   % % %     %
% %%% %%% %%    %%% % % %%%%% % %%%%%
%       %   %     % %     %   % %   %
%%% % %%%%% %%%%% %%% %%% % %%% % %%%
% % % % % % % %     % %   % %   % % %
% % %%% % % % % % %%%%%%% % % % % % %
%   %   %   %                 %     %
% % % % %%% %%% %%%%%%% %%% %%% %%% %
%.%%% %       %   %       %   % %  P%
%%%%%%%%%%%%%%%%%%%%%%%%%%%%%%%%%%%%%