%%%%%%%%%%%%%%%%%%%%%%%%%%%%%%%%%%%%%%%%%%%%%%%%%%%%%%%%%%%%%%%%%%%%%%%%%%
%       %                         %         % % %           %   %   P % %%
%         %%%%% % %%% %%% %%%%%%% %    %%%%%%% % %%% % %%% %%% %%% %%% % %
%       %       % %     %     % %            %       % %     %     % %   %
%%%%% %% %% %%% % % % %%% %%%%% % %%  %%%% %%%%% %%% % % % %%% %%%%% % %%%
%   % % % %   % % % %   % %     %        % % % %   % % % %   % %   % %   %
% %%% % % % %%% %%%%% %%% % %%% %%%    %%% % % % %%% %%%%% %%% % %%% %%% %
%       %     %   %   %     % % %            %     %   %   %     % % %   %
%%% %%%  %%%% %%%%%%% %%% %%% % % %   %% %%%%%%%%% %%%%%%% %%% %%% % % % %
%             %       % %   %     %                %       % %   %     % %
% % %%%%% % %%% % % %%% % %%% %%% %  %%% %%%%% % %%% % % %%% % %%% %%% % %
% % %     % % % % %     %   % % % %    % %     % % % % %     %   % % % % %
% % % %%%%%%% % %%%% %%%% %%% % %%%    % % %%%%%%% % %%%%%%%%% %%% % %%% %
% % % %     %   %     %     %   %      % % %     %   %     %     %   %   %
%%% %%% % %%%%% %%%%% %%% %%% %%%%%    % %%% % %%%%% %%%%% %%% %%% %%%%% %
%     % %               % %   % % %        % % %     % %     % %   % % % %
% % % % %  %  %%% %%% %%% % % % % %    % % % % %%% %%% %%% %%% % % % % % %
% % % % % %%  % % % % %   % % %        % % % %                 % % %     %
% % %%%%%  %  %%% %%% % %%% %%% %%%%  %% %%%%%%% % % %%%%% %%% % %%% %%%%%
%       %  %  % % % % %       % %            % % % %     %   %     % %   %
% %%% % %  %  %%% %%% %%%%%%%%% % %%% %%%% % % %%%%  %%% %%%%%%%%%%% % %%%
%   % %                   %   % %    %   % %           % %     %   % %   %
% %%% %%%%%%%%%%  %%%%%%%%% % % %%%   %%%% %%%%% %%  %%%%% %%%%% % % %%% %
% %                         %         %%   %      %        %     %       %
% % % %%%%% %%% % % % % %%%%%% %%%%%  %% % %%%%% %%% % % % % %%%%%%%%%%%%%
% % %   %     % % % %       %   % %   %% %   %     % % % %       %   % % %
% % %%% %%% % % % %%  %%%%% %%  % %    % %%% %%% % % % %%%%  %%% %%% % % %
% %   % %   % % %   % %   % %       %  %   % %   % % %   % %   % % %     %
% %%% %%% %%% % %%% % % %%%%%   %%%%%  %%% %%% %%%%% %%% % % %%%%% % %%%%%
%       %   %     %       %     %   %        %   %     % %     %   % %   %
%%% % %%%%% %%%%% %%% %%% % %%% % %%% %% % %%%%% %%%%% %%% %%% % %%% % %%%
% % % % % % % %     % %   % %   % % %  % % % % % % %     % %   % %   % % %
% % %%% % % % % %%%%%%%%% % % % % % %  % %%% % % % % %%  %%%%% % % % % % %
%       %                     %     %    %   %   %                 %     %
% %   % %%% %%% %%%%%%% %%% %%% %%% %  % % % %%% %%% %%%%%%% %%% %%% %%% %
% %   %       %           %     %   %  % % %       %   %       %   % %   %
%       %                         %         % % %           %   %     % %%
%         %%%%% % %%% %%% %%%%%%% %    %%%%%%% % %%% % %%% %%% %%%%%%% % %
%       %       % %     %     % %            %       % %     %     % %   %
%%%%% %%%%% %%% % % % %%% %%%%% % %%  %%%% %%%%% %%% % % % %%% %%%%% % %%%
%   % % % %   % % % %   % %     %        % % % %   % % % %   % %   % %   %
% %%% % % % %%% %%%%% %%% % %%% %%%    %%% % % % %%% %%%%% %%% % %%% %%% %
%       %     %   %   %     % % %            %     %   %   %     % % %   %
%%% %%%%%%%%% %%%%%%% %%% %%% % % %   %% %%%%%%%%% %%%%%%% %%% %%% % % % %
%             %       % %   %     %                %       % %   %     % %
% % %%%%% % %%% % % %%% % %%% %%% %%%% % %%%%% % %%% % % %%% % %%% %%% % %
% % %     % % % % %     %   % % % %    % %     % % % % %     %   % % % % %
% % % %  %%%% % %%  %%%%% %%% % %%%    % % %%%%%%% % %%%%%%%%% %%% % %%% %
% % % %     %   %     %     %   %      % % %     %   %     %     %   %   %
%%% %%% % %%%%% %%%%% %%% %%% %%%%%    % %%% % %%%%% %%%%% %%% %%% %%%%% %
%     % %               % %   % % %        % % %     % %     % %   % % % %
% % % % %  %  %%% %%% %%% % % % % %    % % % % %%% %%% %%% %%% % % % % % %
% % % % % %%  % % % % %   % % %        % % % %                 % % %     %
% % %%%%%  %  %%% %%% % %%% %%% %%%%  %% %%%%%%% % % %%%%% %%% % %%% %%%%%
%       %  %  % % % % %       % %            % % % %     %   %     % %   %
% %%% % %  %  %%% %%% %%% %%%%% % %%% %%%% % % %%%%%  %% %%%%%%%%%%% % %%%
%   % %                   %   % %    %   % %           % %     %   % %   %
% %%% %%%%%%%%%%%%%%%%%%%%% % % %%%   %%%% %%%%% %%%%%%%%% %%%%% % % %%% %
% %                         %         %%   %      %        %     %       %
% % % %%%%% %%% % % % % %%%%%%  %%%% %%% % %%%%% %%% % % % % %%%%%%%%%%%%%
% % %   %     % % % %       %   % %   %% %   %     % % % %       %   % % %
% % %%% %%% % % % %%%%%%%%% %%% % % %  % %%% %%% % % % %%%%%%%%% %%% % % %
% %   % %   % % %   % %   % % %     %  %   % %   % % %   % %   % % %     %
% %%% %%% %%% % %%% % % %%%%% % %%%%%  %%% %%% %%%%% %%% % % %%%%% % %%%%%
%       %   %     %       %   % %   %        %   %     % %     %   % %   %
%%% % %%%%% %%%%% %%% %%% % %%% % %%% %% % %%%%% %%%%% %%% %%% % %%% % %%%
% % % % % % % %     % %   % %   % % %  % % % % % % %     % %   % %   % % %
% % %%% % % % % %%%%%%%%% % % % % % %  % %%% % % % % %%%%%%%%% % % % % % %
%       %                     %     %    %   %   %                 %     %
% %   % %%% %%% %%%%%%% %%% %%% %%% %  % % % %%% %%% %%%%%%% %%% %%% %%% %
%.%   %       %           %     %   %  % % %       %   %       %   % %   %
%%%%%%%%%%%%%%%%%%%%%%%%%%%%%%%%%%%%%%%%%%%%%%%%%%%%%%%%%%%%%%%%%%%%%%%%%%